##..##..##
##########
#..#..#..#
##########
##..##..##